0 ZPM Zero Pose 0 0 0 0 0 0 0
1 3way A B 1 2 0 0 0 0 0
2 3way B C 3 2 0 0 0 0 0
3 3way C C 2 1 0 0 0  0 0
4 3way D C 0 0 0 0 0 0 0
5 4way A C 0 0 0 0 0 0 0
6 4way B C 1 0 0 0 0 0 0
7 4way C C 0 1 0 0 0 0 0
8 4way D C 0 0 1 0 0 0 0